16
################
#A...........$.#
#......#$......#
#...#########..#
#...#..$...$...#
#$..#..........#
##.....#####...#
#......#$......#
#$..#..........#
#...######.....#
#......###.....#
#......#$......#
#$..#..........#
#...#..###.$...#
#...#$.#$.....B#
################