22
######################
#A.................###
#...#############....#
#.####################
#..$.$.$.$..$.$.$.$..#
####################.#
##...############....#
###.....#######......#
#####.....####.......#
#######....##........#
#.........$..........#
#..........$.........#
#.##........#######.##
#.###.......#######..#
#.####....######.....#
#.#####.##############
#.####################
#..$.$.$.$..$.$.$.$..#
#..#################.#
#.....##############.#
#..################.B#
######################