16
################
#A...$..#....$.#
#.....###...#..#
#.$....$....#..#
#.#....###..##.#
#.#...#........#
#....###....#..#
#.....#.....#..#
#.....#....##.##
###.........#..#
#......####....#
#$.....#$......#
#..........##$.#
#####...$..#...#
#.......#.....B#
################